100,999,999,999,999,999,999,999,999,999,999,999,999,999,999,999,999,999,999,100
100,100,100,100,100,999,999,999,999,999,999,999,999,100,100,100,100,100,100,100
100,999,999,999,999,999,999,999,999,999,999,999,999,999,999,999,999,999,999,100
100,999,999,999,999,999,999,999,999,999,999,999,999,999,999,999,999,999,999,100
100,999,999,999,999,999,999,999,999,999,999,999,999,999,999,999,999,999,999,100
100,999,999,999,999,999,100,100,999,999,999,999,999,999,999,999,999,999,999,100
100,999,999,999,999,999,999,999,999,999,999,999,999,999,999,999,999,999,999,100
100,999,999,999,999,999,999,999,999,999,999,999,999,999,999,999,999,999,999,100
100,999,999,999,999,999,999,999,999,999,999,999,999,999,999,999,999,999,100,100
100,999,999,999,999,999,999,999,999,999,999,999,999,999,999,999,999,999,100,100
100,999,999,999,999,999,999,999,999,999,999,999,999,999,999,999,999,999,100,100
102,999,999,999,999,999,999,999,999,999,999,999,999,999,999,999,999,999,100,100
102,999,999,999,999,999,999,999,999,999,999,999,100,999,999,999,999,999,100,100
100,100,100,100,100,100,999,999,101,101,101,100,100,101,100,100,100,100,100,100
100,100,100,100,100,100,999,999,101,101,101,100,100,101,100,100,100,100,100,100
,,,,,,,,,,,,,,,,,,,
999,999,999,999,999,999,999,999,999,999,999,999,999,999,999,999,999,999,999,999
999,999,999,999,999,999,999,999,999,999,999,999,999,999,999,999,999,999,999,999
999,999,999,999,999,999,999,999,999,999,999,999,999,999,999,999,999,999,999,999
999,999,999,999,999,999,999,999,999,999,999,999,999,999,999,999,999,999,999,999
999,999,999,999,999,999,2,999,999,999,999,999,999,999,999,999,999,999,999,999
999,999,999,999,999,999,999,999,999,999,999,999,999,999,999,999,999,999,999,999
999,999,999,999,999,999,999,999,999,999,999,999,999,999,999,999,999,999,999,999
999,999,999,999,999,999,999,999,999,999,999,999,999,999,999,999,999,999,999,999
999,999,999,999,999,999,999,999,999,999,999,999,999,999,999,999,999,20,999,999
999,999,999,999,999,999,999,999,999,999,999,999,999,999,999,999,999,999,999,999
999,999,999,999,999,999,999,999,999,999,999,999,999,999,999,999,999,999,999,999
999,999,999,999,999,999,999,999,999,999,999,999,999,999,999,999,999,999,999,999
999,999,0,999,999,999,999,999,999,2,999,999,999,999,999,999,999,999,999,999
999,999,999,999,999,999,999,999,999,999,999,999,999,999,999,999,999,999,999,999
999,999,999,999,999,999,999,999,999,999,999,999,999,999,999,999,999,999,999,999
